NO textures/t7.xpm
SO textures/t5.xpm
WE textures/t6.xpm
EA textures/t8.xpm


F 222,184,135
C 0,0,255



11111111111111111111111111111111111
10000000000000000000000000000000001
10111111111111111111111111111111001
10000000000000000000000000000000001
10001111111111100011111111111000001
10001000000000100010000000001000001
1000100001111011101000001110100000111
1000100001000000001N000100010000000001
10001000010000000010000010001000001111
10001000011111111110000011111000011111
100010000000000001100000000000000111
111111111111111111111111111111111111
11111111111111111111111111111111111